temperature	process condition
industrial	industry
iraq	nation
lamb	meat
computer	equipment
integrated circuit	electronic component
horse	mammal
fennel	herb
india	region
tennis	amenity
wind power	energy source
september 11	event
heat stabilizer	additive
porch	area
dna methylation	epigenetic mechanism
food	perishable goods
tag	game
rice	food crop
intellectual property	intangible asset
health	subject
jacket	item
tumor size	factor
phenolic acid	phenolic compound
nickel complex	metal complex
enclosure	product
green tea extract diet	ridiculous diet
age	personal characteristic
form	information
size	feature
facial	spa treatment
environmental protection agency	federal agency
pastry	baked goods
pen	tool
reading	interest
spider	animal
butter	dairy product
crop rotation	cultural practice
flexibility	property
eczema	skin problem
ip address	information
music	field
solvent	product
sport	category
monster com	free site
diarrhea	adverse effect
printer	external peripheral
natural disaster	event
high blood pressure	complication
gold	natural resource
cancer cell	cell
french fries	high fat food
gap	brand
cable	utility
ct scan	test
yoga	flexibilityexercise system
belt	accessory
switzerland	nation
ethnicity	demographic characteristic
park	public space
prayer	spiritual practice
contrast	factor
forum	feature
cortisol	steroid hormone
manganese	trace element
tendon	tissue
back pain	condition
sulphur dioxide	pollutant
copper	metal
earthquake	natural disaster
water	utility service
gluten free	dietary requirement
scarf	prop
nike	corporation
speed	information
dehydration	complication
zinc	trace metal
energy	concept
earthquake	hazard
radio	electronic equipment
aphid	pest
human resource	department
healthcare expense	small financial cost
lifestyle	topic
inequality	issue
cosmopolitan	magazine
milk thistle	herb
e-mail	service
water	drink
trypsin	protease
blood test	diagnostic test
alga	organism
aids	condition
alarm system	device
sodium	cation
cricket	insect
garlic	flavor
shop	place
length	information
java	programming language
walker	equipment
flour	product
bleeding	side effect
paper towel	paper product
marble	stone
colonoscopy	procedure
money	item
sleep disturbance	symptom
protein	essential nutrient
fructose	monosaccharide
shovel	hand tool
butane	hydrocarbon
phosphatidylcholine	phospholipid
waterskiing	activity
plastic	substrate
enron	scandal
diarrhea	condition
surface area	property
receipt	document
diabetes	vascular risk factor
ribbon	embellishment
perfume	chemical
roulette	game
risk	concept
malaria	infectious disease
part	product
sugar beet	crop
germanium	semiconductor
rhode island reds	common larger breed
telephone bill	small financial cost
picture	hang heavy item
college	institution
national park	protected area
massage	service
panasonic	manufacturer
email	feature
highway	surface
microsoft windows	system
macy s	retailer
element	term
boxing	contact sport
wedding	private function
thermal conductivity	material property
herbicide	chemical
twitter	social networking site
trade	topic
chicken	farm animal
first	term
hadoop	technology
hydrogen peroxide	ros
whole grain	complex carbohydrate
web beacon	standard internet technology
ibm	company
packaging	factor
citrate	buffer
customer service	department
drawing	activity
politic	area
healthcare expense	financial cost
iron	essential nutrient
smartphone	mobile computing device
arabidopsis	plant
billiard	activity
shortness of breath	symptom
carbamazepine	anticonvulsants
facebook	network
vehicle repair	brief term need
david bowie	artist
truth	concept
word	office application
elephant	wild animal
salmonella	pathogen
snowboarding	winter sport
copper	heavy metal
mortgage	expense
aircraft	vehicle
german shepherd	breed
adenovirus	viral vector
agricultural	industry
prozac	selective serotonin reuptake inhibitor
cpu	component
ketoprofen	nsaid
library	public facility
car	purchase
hypotension	side effect
water	coolant
service	activity
wireless network	serial interface
environmental degradation	issue
staple	fastener
ethyl	alkyl radical
cellulose	carbohydrate
email address	information
temperature	water quality parameter
bathroom cleaning	service
surgery	treatment
eczema	skin disease
image	datum
information	resource
credit risk	risk
software	intangible asset
